5;5
&, , , , ;L,0,w, , ;&, , , , ;&, , , , ;&, , , , 
L,0,w,t, ;L,0,w, ,k;&, , , , ;L,1, , , ;&, , , , 
&, , , , ;L,1, , ,p;L,1, , , ;L,1, ,f,s;&, , , , 
&, , , , ;&, , , , ; , , , , ;&, , , , ;&, , , , 
&, , , , ;L,1,w,t,p; , , , , ;&, , , , ;L,0, ,t,h